20,20,20,20,20,20,20,20,20,20,20,20,20,20,20,20,20,20,20,20,20,20,20,20,20,20,20,20,20,20,20,20,20,20,20,20,20,20,20,20,20,20,20,20,20,20,20,20,20,20
20,49,84,84,84,84,84,84,84,84,84,84,84,84,84,84,84,84,84,84,84,84,84,84,84,84,84,84,84,84,84,84,84,84,84,84,84,84,84,84,84,84,84,84,84,84,84,84,50,20
20,81,32,32,32,32,32,16,48,16,16,16,64,16,48,48,48,80,80,80,80,80,80,48,80,48,80,48,64,80,80,80,80,48,64,48,64,48,64,48,64,64,80,80,64,48,16,16,82,20
20,81,32,32,32,191,16,32,64,32,32,32,80,32,48,48,80,48,16,16,80,80,80,80,80,48,80,80,48,80,16,64,80,64,64,48,48,48,64,64,64,48,80,80,80,64,16,64,82,20
20,81,16,16,48,32,64,32,80,48,64,64,64,64,64,48,48,48,80,80,16,80,80,80,80,80,80,80,80,80,80,80,64,64,48,80,48,48,64,80,64,64,80,64,80,80,16,64,82,20
20,81,16,32,64,48,80,48,64,64,64,64,80,32,48,48,16,80,80,80,80,16,16,80,80,80,80,80,80,80,80,80,80,48,80,80,80,48,80,64,64,64,64,80,16,80,16,64,82,20
20,81,16,48,80,64,64,16,64,64,64,80,64,16,48,16,16,80,80,80,80,80,48,80,80,80,48,16,80,16,80,80,80,80,80,80,80,80,16,16,16,16,80,80,64,16,16,16,82,20
20,81,16,16,48,32,80,32,80,64,16,16,80,32,48,80,80,16,64,80,80,80,80,80,80,80,16,80,80,80,80,48,80,48,16,80,80,80,16,80,80,16,16,16,64,16,16,16,82,20
20,81,16,32,64,48,64,48,48,64,32,32,64,64,80,64,64,16,64,48,48,48,80,80,80,16,16,48,16,80,80,80,80,64,16,16,64,80,16,80,64,80,16,16,64,16,16,64,82,20
20,81,16,48,80,64,80,16,64,64,48,48,80,32,80,80,80,80,16,48,48,16,80,80,80,80,80,16,16,48,80,48,80,48,64,64,16,16,16,64,80,80,80,16,64,16,16,48,82,20
20,81,16,16,64,32,64,32,16,16,16,16,16,16,16,80,80,80,16,16,16,80,64,80,80,80,80,48,48,16,80,16,80,16,64,64,16,16,64,48,80,80,80,16,64,16,16,64,82,20
20,81,16,16,16,16,16,16,48,80,64,80,80,32,80,16,16,16,16,16,48,80,16,16,80,16,80,80,80,48,80,16,80,16,16,16,64,16,16,48,80,80,16,64,16,16,16,64,82,20
20,81,16,16,80,80,80,80,80,80,80,80,80,80,16,16,80,16,48,16,48,80,16,16,16,16,48,48,80,80,80,80,80,80,48,48,64,48,16,48,80,80,64,16,16,64,16,80,82,20
20,81,80,80,16,80,80,16,80,80,32,64,80,16,16,16,16,16,16,16,16,80,16,16,16,16,16,16,48,48,80,48,80,80,80,48,80,48,80,48,80,80,16,16,64,16,16,80,82,20
20,81,80,80,80,48,64,64,80,48,16,16,16,16,16,16,16,16,48,16,16,80,16,16,16,48,16,16,16,48,48,80,80,80,80,48,80,80,48,80,80,16,16,64,80,16,80,80,82,20
20,81,16,48,64,64,80,80,80,80,64,64,80,64,80,16,16,16,48,16,16,80,16,16,16,48,48,48,80,48,48,80,80,80,80,80,80,48,64,80,16,16,16,64,64,16,80,64,82,20
20,81,16,16,64,32,64,80,80,80,80,80,80,64,80,16,80,16,16,16,16,48,80,48,16,16,48,48,48,48,80,16,16,16,80,48,48,48,48,16,16,16,80,80,64,64,80,80,82,20
20,81,16,32,64,48,80,48,80,80,80,16,80,80,16,16,80,16,48,16,48,80,16,80,80,80,80,16,16,48,64,16,48,48,80,48,16,64,48,64,48,16,64,80,64,64,64,80,82,20
20,81,16,48,64,64,64,16,80,80,32,80,16,16,80,16,80,64,48,16,16,16,80,80,48,48,80,80,80,16,16,16,48,16,80,48,80,80,16,64,48,48,16,80,80,16,64,80,82,20
20,81,16,16,48,64,80,80,80,64,48,80,64,64,80,80,48,48,48,48,16,80,80,80,48,16,16,48,80,80,80,48,16,64,16,48,48,64,16,64,64,48,16,16,16,16,64,80,82,20
20,81,16,32,64,64,64,80,64,64,80,64,64,16,16,80,80,80,16,48,16,16,80,80,48,16,48,64,16,48,80,48,80,80,48,48,48,64,16,80,48,48,80,64,16,16,64,80,82,20
20,81,16,48,80,64,80,80,16,80,16,64,16,16,16,48,80,80,80,48,16,80,80,80,80,80,80,80,80,80,48,16,16,16,16,16,48,48,16,48,48,64,64,64,48,16,64,80,82,20
20,81,16,16,48,80,80,16,16,80,16,16,16,16,48,48,48,80,80,80,80,16,48,16,16,16,48,48,48,48,16,80,64,16,48,48,16,16,48,48,64,64,64,64,80,80,80,64,82,20
20,81,16,32,64,80,64,48,80,16,16,16,64,48,48,16,80,48,80,80,80,16,16,16,48,16,48,48,48,48,48,48,48,48,48,80,48,48,16,16,80,80,64,64,64,80,48,48,82,20
20,81,16,48,80,64,64,16,80,16,16,64,48,48,80,80,48,80,80,80,16,80,80,48,48,48,48,48,48,64,80,16,48,48,48,80,80,80,80,16,80,64,64,64,80,48,80,64,82,20
20,81,16,16,48,32,64,32,80,16,16,64,80,48,16,48,48,80,80,80,16,64,80,80,80,80,16,16,16,64,16,48,48,64,48,48,48,80,80,16,16,80,64,48,48,80,48,48,82,20
20,81,16,32,64,48,64,80,64,16,80,80,48,48,80,64,16,16,80,80,16,48,48,80,48,80,80,80,80,80,48,16,48,48,64,64,48,64,48,16,80,16,16,48,48,80,48,48,82,20
20,81,16,48,80,64,80,16,64,16,80,48,48,48,80,80,48,48,80,80,48,48,16,48,80,48,80,16,16,80,16,48,48,48,80,48,16,80,64,64,16,48,16,80,48,64,48,48,82,20
20,81,16,16,48,80,64,32,80,80,16,16,48,48,80,48,48,48,80,16,80,48,48,48,80,80,80,48,48,80,80,48,64,64,48,80,64,80,80,64,16,48,80,16,80,80,48,48,82,20
20,81,16,32,64,80,64,80,80,16,16,16,48,32,80,64,16,80,80,16,80,80,80,80,16,80,80,48,48,80,80,80,80,80,48,80,80,48,64,80,48,16,48,64,16,80,80,48,82,20
20,81,16,48,80,80,80,16,64,16,64,16,16,48,16,16,80,80,80,16,48,80,80,16,16,80,48,80,48,80,48,64,64,48,80,80,80,80,64,48,64,64,48,16,16,16,80,48,82,20
20,81,16,16,64,64,80,32,80,16,80,80,16,64,48,80,48,80,80,16,48,80,80,80,80,48,80,80,80,80,48,16,64,48,64,64,64,80,48,80,80,48,80,16,16,16,80,48,82,20
20,81,16,32,64,48,64,48,48,16,64,80,64,16,16,80,48,80,80,16,48,16,16,80,80,16,16,80,80,48,80,64,64,48,16,64,64,48,80,80,80,48,80,80,16,16,80,48,82,20
20,81,16,64,80,64,80,16,64,32,16,80,80,80,80,48,16,80,48,16,16,16,16,48,80,48,80,80,80,48,48,80,80,48,64,16,48,16,48,80,48,48,64,64,16,16,16,16,82,20
20,81,16,64,64,64,64,32,80,48,48,48,48,48,48,48,80,80,48,16,48,48,48,48,80,80,48,48,80,48,48,64,48,64,16,64,48,64,16,16,48,80,64,64,16,80,80,16,82,20
20,81,16,32,64,48,64,64,48,48,16,64,48,80,80,48,48,80,48,16,48,48,48,80,80,80,16,16,80,80,80,80,80,80,80,48,80,64,16,64,48,64,80,16,80,80,80,16,82,20
20,81,16,48,80,64,64,16,48,64,64,16,48,80,80,48,16,80,48,48,16,64,48,16,64,80,80,16,16,16,80,48,48,80,80,64,64,80,80,80,48,16,16,64,80,80,64,16,82,20
20,81,16,16,48,32,80,32,80,48,64,48,48,48,48,80,80,16,80,80,16,16,48,48,80,80,64,16,80,80,16,48,48,48,80,16,16,16,16,16,16,16,16,64,80,80,64,16,82,20
20,81,16,32,64,48,64,48,48,64,48,48,48,48,48,80,48,80,80,80,80,80,80,80,80,80,16,16,80,48,48,48,80,80,64,64,64,16,16,16,48,48,16,80,80,80,64,64,82,20
20,81,16,48,80,64,80,16,64,64,48,48,80,64,80,48,16,48,80,80,80,80,16,16,80,16,16,16,16,16,16,80,80,16,16,16,16,64,48,16,64,80,48,16,80,64,16,64,82,20
20,81,16,16,48,32,64,32,80,64,64,64,80,64,80,48,48,80,80,16,48,48,80,80,80,80,80,80,80,80,80,48,80,80,16,16,64,64,48,16,48,64,48,16,16,16,16,48,82,20
20,81,16,32,64,48,80,48,48,64,64,64,80,80,80,80,48,80,16,16,48,16,80,48,16,48,48,64,16,48,48,80,80,64,80,16,16,48,64,16,16,16,48,80,16,16,16,64,82,20
20,81,16,48,80,64,64,16,64,16,16,16,64,64,80,48,64,48,48,48,48,80,48,16,48,48,48,16,48,48,48,80,80,64,64,80,16,64,64,64,16,64,48,16,16,16,16,16,82,20
20,81,16,16,48,32,64,64,80,32,64,64,64,32,80,80,80,80,80,80,80,80,48,16,16,16,16,48,48,48,16,80,80,80,80,80,16,16,64,64,16,16,48,16,80,80,16,48,82,20
20,81,16,64,64,64,64,64,64,64,64,48,64,16,48,48,80,80,16,16,16,16,48,16,16,16,48,80,64,16,16,16,64,64,80,80,80,16,64,64,16,16,48,48,48,48,48,48,82,20
20,81,16,48,80,64,80,16,64,64,64,80,80,80,80,80,80,80,80,80,64,48,80,80,80,48,64,64,64,16,80,16,16,64,80,64,80,16,16,80,16,16,16,64,80,80,64,80,82,20
20,81,16,16,48,32,64,32,80,80,80,80,64,80,80,80,80,80,80,80,80,48,80,80,48,64,80,80,80,80,16,64,16,16,64,16,16,16,16,16,16,16,80,80,80,16,16,16,82,20
20,81,16,32,64,48,80,48,48,16,16,16,80,32,80,48,80,64,64,64,64,48,48,48,80,80,64,48,64,48,16,16,16,16,64,16,16,64,64,80,80,80,80,80,64,80,64,16,82,20
20,65,83,83,83,83,83,83,83,83,83,83,83,83,83,83,83,83,83,83,83,83,83,83,83,83,83,83,83,83,83,83,83,83,83,83,83,83,83,83,83,83,83,83,83,83,83,83,66,20
20,20,20,20,20,20,20,20,20,20,20,20,20,20,20,20,20,20,20,20,20,20,20,20,20,20,20,20,20,20,20,20,20,20,20,20,20,20,20,20,20,20,20,20,20,20,20,20,20,20
